PlaceName	CleanedName	Components	Meaning
Ahuroa	Ahuroa	ahu: mound; roa: long	Long mound
Aoroa	Aoroa	ao: cloud; roa: long	Long cloud
Aotearoa	Aotearoa	ao: cloud; tea: white; roa: long	Land of the long white cloud
Aramoana	Aramoana	ara: path; moana: sea	Sea pathway
Aranui	Aranui	ara: path; nui: great	Great pathway
Arapae	Arapae	ara: path; pae: ridgeway	Pathway along the ridge
Arapito	Arapito	ara: path; pito: end or extremity	End of the path
Arapōhue	Arapōhue	ara: path; pōhue: climbing plant	Path of the climbing plant
Arapuni	Arapuni	ara: path; puni: blocked or covered	Blocked path
Ararātā	Ararātā	ara: path; rātā: native tree	Rātā tree path
Ararimu	Ararimu	ara: path; rimu: native tree	Rimu tree path
Ararua	Ararua	ara: path; rua: two	Two paths
Arataha	Arataha	ara: path; taha: side	Side path
Aratapu	Aratapu	ara: path; tapu: sacred or restricted	Sacred path
Aratiatia Lakes, Aratiatia Rapids	Aratiatia	ara: path; tiatia: pegs	Pegged ladder
Aratika	Aratika	ara: path; tika: correct or straight	Direct path
Aratoro	Aratoro	ara: path; toro: discover	Path of discovery
Aropaonui	Aropaonui	aro: kidney fat; paoa: to bash	Bashed kidney fat
Aukati	Aukati	au: line; kati: block	Frontier
Auripo	Auripo	au: current; ripo: whirlpool, or eddying	Eddying current
Auroa	Auroa	au: cloud or mist; roa: long	Long cloud
Awa	Awa	awa: river	River
Awahōhonu River	Awahōhonu	awa: river; hōhonu: deep	Deep river
Awahōu	Awahōu	awa: river; hōu: new	New river
Awaiti	Awaiti	awa: river; iti: little	Little river
Awa-kāeaea	Awa-kāeaea	awa: valley or stream; kāeaea: the sparrow-hawk	Sparrow-hawk stream
Awakeri	Awakeri	awa: river; keri: dig	Ditch or trench
Awakino	Awakino	awa: river; kino: bad, evil, or of bad appearance	Bad creek
Awamangu	Awamangu	awa: river; mangu: black	Black river
Awamarino	Awamarino	awa: stream; marino: calm	Calm stream
Awamoana	Awamoana	awa: stream; moana: sea	Sea stream
Awamoko	Awamoko	awa: stream; moko: lizard	Lizard stream
Awanui	Awanui	awa: river; nui: large	Large river
Awapikopiko	Awapikopiko	awa: stream; pikopiko: winding about	Winding stream
Awapuni	Awapuni	awa: stream; puni: blocked up	Blocked-up river
Awarere	Awarere	awa: stream; rere: to flow	Flowing stream
Awariki	Awariki	awa: river; riki: small	Little river
Awaroa	Awaroa	awa: river or valley; roa: long	Long river
Awarua	Awarua	awa: stream or river; rua: two	Two streams
Awatere River	Awatere	awa: river; tere: swift	Swift river
Awatoitoi	Awatoitoi	awa: stream; toitoi: giant bully	Giant bully stream
Awatōtō	Awatōtō	awa: stream; tōtō: hauling place	Stream for hauling (canoes)
Awatuna	Awatuna	awa: stream; tuna: eel	Eel stream
Eketāhuna	Eketāhuna	eke: run aground or land; tāhuna: sandbank	Land on the sandbank
Epiha	Epiha	Māori form of biblical name Ephesus	Ephesus
Erua	Erua	e: used before cardinal numbers from two to nine; rua: two	Two
Hāpua-waikawa	Hāpua-waikawa	hāpua: pool; wai: water; kawa: bitter	Pool of bitter water
Haumoana	Haumoana	hau: wind; moana: sea	Sea breeze
Haunui	Haunui	hau: wind; nui: big or many	Strong wind
Hiwinui	Hiwinui	hiwi: ridge; nui: big	Big ridge
Hokanui	Hokanui	hoka: projecting sharply upwards; nui: large	Large projection
Houipapa	Houipapa	houi: lacebark; papa: flat	Ribbonwood flat
Houpoto	Houpoto	hou: feathers; poto: short	Short feathers
Hukanui	Hukanui	huka: foam, frost or snow; nui: big	Heavy snow
Hukerenui	Hukerenui	hukere: cascade; nui: large	Large cascade
Hurimoana	Hurimoana	huri: to overflow; moana: ocean	Overflowing ocean
Ihumātao	Ihumātao	ihu: nose; mātao: cold	Cold nose
Ihumoana	Ihumoana	ihu: nose; moana: sea	Nose into the sea
Ikawai	Ikawai	ika: fish; wai: water	Waters of fish
Kā Pukehore	Kā Pukehore	A descriptive name, kā (ngā): the; puke: hill; hore: bare (the peaks were bare of vegetation)	The bare hills
Kā Pukemāeroero	Kā Pukemāeroero	kā (ngā): the; puke: hill; māeroero: ogres of the South Island forests	The hill of ogres
Kaharoa	Kaharoa	kaha: net; roa: long	Large net
Kaiata	Kaiata	kai: to eat: ata: early morning	Eating in the morning
Kaiaua	Kaiaua	kai: to eat; aua: mullet or herrings	Eating mullets
Kai-Hau-o-Kupe	Kai-Hau-o-Kupe	kai: to eat; hau: wind; o: of; Kupe	The place where Kupe ‘ate wind’
Kaihiku	Kaihiku	kai: te eat; hiku: tail of a fish	Eating a fish tail
Kaihinu	Kaihinu	kai: food; hinu: fat	Food preserved in fat
Kaihu	Kaihu	An abbreviation of kai-hu-a-Ihenga, kai: to eat; hu: secretly; a: of; Ihenga	Eat secretly
Kaikarae	Kaikarae	kai: food; karae: seabird	Eat a seabird
Kaikōura	Kaikōura	kai: to eat; koura: crayfish	Eat crayfish
Kaikūmera Bay	Kaikūmera	kai: to eat; kūmera (alternate spelling of kūmara): sweet potato	Eat kūmara
Kaimāī	Kaimāī	kai: food or to eat; māī: mussels, or slightly fermented food	Eat fermented food
Kaimamaku	Kaimamaku	kai: food or to eat; mamaku: edible tree-fern	Eat edible tree-fern
Kaimanawa Mountains	Kaimanawa	kai: food or to eat; manawa: breath (also meaning heart or emotion)	Breath for food
Kaimangō	Kaimangō	kai: food or to eat; mangō: shark	Eating shark
Kaimata	Kaimata	kaimata: unripe or uncooked food	Eat raw food
Kaimātaitai	Kaimātaitai	kai: food; mātaitai: salty	Eat seafood
Kaimaumau	Kaimaumau	kai: food; maumau: to waste	Eat food
Kaimiro	Kaimiro	kai: food or to eat; miro: a tree	Eat miro berries
Kainamu	Kainamu	kai: to eat; namu: sandflies	Eat sandflies
Kāingaroa	Kāingaroa	kāinga: area of land; roa: long	Long area of land
Kāingaroa Plain	Kāingaroa	Kāinga: place where food has been cooked and eaten; roa: long	Long meal
Kaipākirikiri	Kaipākirikiri	kai: food; pākirikiri: rock cod	Eating rock cod
Kaipara Flats	Kaipara	kai: te eat; para: fern-root	Eat fern-root
Kaiparoro	Kaiparoro	kai: to eat; paroro: bad weather	Eating up bad weather
Kaipō Bay	Kaipō	kai: to eat; pō: night	Eat night
Kaipuke	Kaipuke	kai: to eat; puke: swell, flood	Ship (wave eater)
Kaipūpū	Kaipūpū	kai: food; pūpū: shellfish	Eat shellfish
Kairākau	Kairākau	kai: to eat; rākau: wood.	Eat wood
Kairaki	Kairaki	kai: eat; raki (South Island form of rangi); sky	Sky eater
Kairara	Kairara	kai: food; rara: to be spread out on a stage for drying in the sun	Food spread out on a stage to dry
Kairua	Kairua	kai: food; rua: pit	Food pit
Kaitakata	Kaitakata	South Island variant of Kaitangata – kai: to eat; tangata: man	Man eater (South Island form)
Kaitangata	Kaitangata	kai: to eat; tangata: man	Man eater
Kaitangiweka	Kaitangiweka	kai: food; tangi: to cry; weka: wood hen	Crying of the weka for food
Kaitapeha	Kaitapeha	kai: to eat; tapeha: rind or skin	Eat the rind
Kaitawa	Kaitawa	kai: food; tawa: tree or berries	Eat tawa berries
Kaitieke	Kaitieke	kai: to eat; tieke: the saddleback bird	Eat the saddleback bird
Kaitoke	Kaitoke	kai: to eat, or food; take: worm	Eat worms
Kaitoki	Kaitoki	kai: food; toki: adze	Food for the adze
Kaituna	Kaituna	kai: to eat; tuna: eel	Eat eels
Kai-waha-onepū	Kai-waha-onepū	kai: food; waha: mouth; onepū: sand	Biting the sand
Kaiwaka	Kaiwaka	kai: to eat; waka: canoe	Eating the canoes
Kaiwera	Kaiwera	kai: food; wera: hot	Hot food
Kaiwharawhara	Kaiwharawhara	kai: food or to eat; wharawhara: the fruit of the astelia	Eat the fruit of the astelia
Kakīroa	Kakīroa	kakī: neck or throat; roa: large	Long neck
Kararoa	Kararoa	kara: this word has many meanings, one of which is old man; roa: tall	Tall elderly man
Kauroa	Kauroa	kau: to swim; roa: long	Long swim
Kereone	Kereone	kere: earth; one: sand or sandy	Sandy earth
Kererū	Kererū	kererū: wood pigeon	Wood pigeon
Keteketerau	Keteketerau	ketekete: click the tongue; rau: many times	Click the tongue repeatedly
Ketetahi springs	Ketetahi	Kete: basket; tahi: one	One spring
Kihikihi	Kihikihi	kihikihi: cicada	Cicada
Kihitū	Kihitū	kihi: to strip off; tū: girdle or belt to which a maro (loincloth) was attached	Strip off the girdle
Kioreroa	Kioreroa	kiore: native rat; roa: long	Long rat
Kirkiriroa	Kirkiriroa	kirikiri: gravel; roa: long	Long gravel
Kiwinui	Kiwinui	kiwi: bird; nui: many	Many kiwi birds
Kōhīnui	Kōhīnui	kōhī: dark mud (used in dyeing), heavy rain, skeleton, youth, etc.; nui: large, many or plenty	Plenty of dark mud
Kohukohunui	Kohukohunui	Lit: kohukohu: mist; nui: big or many	Great mist
Kōpūtai	Kōpūtai	kōpū: full; tai: tide	Full tide
Kōputaroa	Kōputaroa	kōputa: snare for catching parakeets; roa: long	Long snare for catching parakeets
Kōpūwai	Kōpūwai	kōpū: belly or full; wai: water	Water swallower
Korakonui	Korakonui	korako: albino; nui: big	Large albino (bird)
Kororāreka	Kororāreka	kororā: blue penguin; reka: sweet or tasty	Tasty blue penguin
Kōtuku	Kōtuku	kōku: white heron	White heron
Kōtuku-moana	Kōtuku-moana	kōtuku: white heron; moana: lake	Lake of white herons
Kōurarau	Kōurarau	kōura: crayfish; rau: many	Many crayfish
Koutunui	Koutunui	koutu: headland; nui: large	Large headland
Kumeroa	Kumeroa	kume: to pull; roa: long	Long drag
Kuranui	Kuranui	kura: red; nui: large red birds	Big red (birds)
Makakahikatoa	Makakahikatoa	maka: strike; kahikatoa: red mānuka (Leptospermum scoparium) or more probably a weapon made from this wood	Striking with mānuka stick
Makarānui	Makarānui	makarā: to come and go; nui: many	Much coming and going
Mākikihi	Mākikihi	ma: stream; kikihi: cicada (Amphipsalta cingulata)	Cicada stream
Mākirikiri	Mākirikiri	ma: stream: kirikiri: gravel	Gravelly stream
Mākōhine Valley	Mākōhine	mā: stream; kōhine: girl	Young woman's stream
Mākōtuku	Mākōtuku	mā: stream; kōtuku: white heron	White heron stream
Mākōwhai	Mākōwhai	Mā: stream; kōwhai: tree	Kōwhai tree stream
Mākurī	Mākurī	mā: stream; kurī: dog	Dog stream
Māmāranui	Māmāranui	mā: stream; māra: farm or cultivation; nui: large or many	Stream for many gardens
Manaroa	Manaroa	mana: power or prestige; roa: great or long	Enduring prestige
Mangaharakeke	Mangaharakeke	manga: stream; harakeke: flax bush	Stream of flax
Mangahoe	Mangahoe	manga: stream; hoe: canoe paddle	Stream of canoe paddles
Mangahouhounui Stream	Mangahouhounui	manga: stream; houhou: five-finger tree; nui: large or many	Stream of many five finger trees
Mangaiti	Mangaiti	manga: stream; iti: tiny	Small stream
Mangakāhia	Mangakāhia	manga: stream; kāhia or kōhia: native passion vine	Stream of New Zealand passionfruit
Mangakino	Mangakino	manga: stream; kino: bad, usless or stagnant	Stagnant stream
Mangakura	Mangakura	manga: stream; kura: red or red ochre	Stream of red ochre
Mangamāhoe	Mangamāhoe	manga: stream; māhoe: native tree, whiteywood (Melicytus ramiflorus)	Māhoe stream
Mangamahu	Mangamahu	manga: stream; mahu: gentle	Gentle stream
Mangamaire	Mangamaire	manga: stream; maire: native tree	Maire stream
Mangamuka	Mangamuka	manga: stream; muka: the furled shoot of the nīkau palm	Stream of the furled shoot of the nīkau palm
Mangamutu	Mangamutu	manga: stream; mutu: finished	Finished stream
Mangangarongaro: Mangangarongaro Stream	Mangangarongaro	manga: stream; ngarongaro: somewhat abated	Abated stream
Manganui-a-te-Ao	Manganui-a-te-Ao	manga: stream; nui: great; a: of; te: the; ao: world	Great stream of the world
Mangaohae	Mangaohae	manga: stream o: of; Hae	The stream of Hae
Mangaohutu	Mangaohutu	manga: stream; o: of; Hutu	The stream of Hutu
Mangaonoho	Mangaonoho	manga: stream; o: of; Noho	The stream of Noho
Mangaorapa	Mangaorapa	manga: stream; o: of; Rapa	The stream of Rapa
Mangaore	Mangaore	manga: stream; ore: to poke with a stick, or to bore a hole	The stream where a hole was bored
Mangaotaki	Mangaotaki	manga: stream; o: of; taki: oratory or to make a speech	Stream of oratory
Mangaowera: Mangaowera Stream	Mangaowera	manga: stream; o: of; Wera	The stream of Wera
Mangapai	Mangapai	manga: stream; pai: good	Good stream
Mangapēhi	Mangapēhi	manga: stream; pēhi: troubled	Stream of trouble
Mangapiko	Mangapiko	manga: stream; piko: bent or crooked	Winding stream
Mangapōuri	Mangapōuri	manga: stream; pōuri: dark	Dark stream
Mangapu	Mangapu	manga: stream; pū: double	Double stream
Mangapuaka	Mangapuaka	manga: stream ; puaka: bird snare or rimu tree	Bird snare stream
Mangapūrua	Mangapūrua	manga: stream; pūrua: abundant or plenty	Abundant stream
Mangarakau	Mangarakau	manga: stream; rākau: tree	Stream of trees
Mangaramarama	Mangaramarama	manga: stream; ramarama: native shrub	Stream of the ramarama shrub
Mangarapa	Mangarapa	manga: stream; rapa: broad or spread out	Broad stream
Mangarātā	Mangarātā	manga: stream; rata: native tree	Rātā stream
Mangarawa	Mangarawa	manga: stream; rawa: swamp	Swampy stream
Mangarimu	Mangarimu	manga: stream; rimu: native tree	Rimu stream
Mangaroa	Mangaroa	manga: stream; roa: long	Long stream
Mangatahi	Mangatahi	manga: stream; tahi: single	Single stream
Mangatainoka	Mangatainoka	manga: stream; tainoka: native broom	Native broom stream
Mangatangi	Mangatangi	manga: stream; tangi: weeping or sounding	Stream of weeping
Mangatapu	Mangatapu	manga: stream; tapu: sacred or forbidden	Sacred stream
Mangatarata	Mangatarata	manga: stream; tarata: native tree known as lemonwood	Lemonwood stream
Mangatāwhiri	Mangatāwhiri	manga: stream; tāwhiri: native tree	Tāwhiri tree stream
Mangatea	Mangatea	manga: stream; tea: white or clear	Clear stream
Mangateparu	Mangateparu	manga: stream; te: the paru: mud, dirt, dirty or deep	Stream of mud
Mangatepopo	Mangatepopo	manga: stream; te: the; popo: anything rotten or decayed	Stream of rotten items
Mangateretere	Mangateretere	manga: stream; teretere: swiftly flowing	Swiftly flowing river
Mangatī	Mangatī	manga: stream; tī: cabbage tree	Cabbage-tree stream
Mangatina	Mangatina	manga: stream; tina: exhausted	Exhausted at the stream
Mangatoetoe	Mangatoetoe	manga: stream; toetoe: native grass	Toetoe stream
Mangatuna	Mangatuna	manga: stream; tuna: eel	Eel stream
Mangawara	Mangawara	manga: stream; wara: to make an indistinct sound	Quiet stream
Mangaweka:	Mangaweka:	manga: stream; weka: wood-hen	Weka stream
Mangawhata	Mangawhata	manga: stream; whata: a raised storehouse for food	Raised storehouse stream
Mangawhero	Mangawhero	manga: stream; whero: red	Red stream
Mangōnui	Mangōnui	mangō: shark; nui: large or many	Great shark
Mānia-rauhea	Mānia-rauhea	mānia: plain of flat land; rauhea: tussock grass	Plain of shining tussock
Māniatoto	Māniatoto	mānia: plain; o: of; toto: blood	Plain of blood
Māniatutu	Māniatutu	mānia: plain; tutu: a native tree	Tutu-tree plain
Mānui	Mānui	mā: stream; nui: large	Large stream
Maraenui	Maraenui	marae: courtyard or meeting area; nui: large	Great marae
Maraeroa	Maraeroa	marae: courtyard or meeting area; roa: long	Long marae
Maraetai	Maraetai	marae: courtyard or meeting area; tai: coast	Coastal marae
Māraroa	Māraroa	māra: cultivated area; roa: long, long lasting	Long lasting cultivations
Matakanui	Matakanui	mata: face; ka: blow or scar; nui: large	Scarred face of a large cliff
Mataroa	Mataroa	mata: headland or bluff; roa: long	Long headland
Maunga Mā	Maunga Mā	maunga: mountain; mā: white	White mountain
Maunga-atua	Maunga-atua	maunga: mountain; atua: gods	Mountain of the gods
Maungaharuru	Maungaharuru	maunga: mountain; haruru: to rumble	Rumbling mountain
Maungahaumi	Maungahaumi	maunga: mountain; haumi: timber to lengthen or raise the sides of a canoe	Mountain of canoe timber
Maungakaramea	Maungakaramea	maunga: mountain; karamea: red ochre or speargrass	Red ochre mountain
Maungakiekie	Maungakiekie	maunga: mountain; kiekie: a climbing plant	Kiekie plant mountain
Maunganui	Maunganui	maunga: mountain; nui: tall or large	Large mountain
Maungapōhatu	Maungapōhatu	maunga: mountain; pōhatu: rock or stone	Rocky mountain
Maungaraki	Maungaraki	maunga: mountain or mountains; raki: north	Northern mountain
Maungaroa	Maungaroa	maunga: mountain; roa: long	Long mountain
Maungataketake	Maungataketake	maunga: mountain; taketake: base, long-established or well-founded	Broad mountain
Maungataniwha	Maungataniwha	maunga: mountain; taniwha: supernatural creature	Taniwha mountain
Maungatāpere	Maungatāpere	maunga: mountain; tāpere: red, volcanic earth	Mountain of red volcanic earth
Maungatapu	Maungatapu	maunga: mountain; tapu: sacred or forbidden	Sacred mountain
Maungatautari	Maungatautari	maunga: mountain; tautari: an upright stick	Mountain of the upright stick
Maungatī	Maungatī	maunga: mountain; tī: cabbage tree	Cabbage tree mountain
Maungatua	Maungatua	maunga: mountain; a: of; atua: god	Mountain of the gods
Maungatūroto	Maungatūroto	maunga: mountain; tū: to stand; roto: lake	Mountain standing up in lagoons
Maungawera	Maungawera	maunga: mountain; wera: burnt or hot	Burnt mountain
Maungawhau	Maungawhau	maunga: mountain; whau: a native tree	Whau tree mountain
Māwheranui	Māwheranui	Māwhera: open, widesread; nui: large (referring particularly to the river mouth).	Broad and widespread (river mouth)
Mititai	Mititai	miti: to lick; tai: tide	Lick the tide
Moana	Moana	Ocean or large lake	Ocean
Moanariri	Moanariri	moana: sea; riri: to be angry or to fight	Angry sea
Moanaroa	Moanaroa	moana: ocean; roa: large or broad	Broad sea
Moanawhenuapōuri	Moanawhenuapōuri	moana: sea; whenua: land; pōuri: sad or dark	Sombre arm of the sea
Moeroa	Moeroa	moe: to sleep; roa: long	Long sleep
Mōkihinui	Mōkihinui	mōkihi: raft made of flax stalks; nui: large	Large flax-stalk raft
Mokoroa	Mokoroa	moko: tattoo; roa: long	Long tattoo
Mokoroa: Mokoroa Stream	Mokoroa	moko: lizard; roa; long	Long lizard
Motuara: Motuara Island	Motuara	motu: island; ara: path	Island in the path (of a canoe)
Motuarohia: Motuarohia Island	Motuarohia	motu:island; arohia: reconnoitred	Reconnoitred island
Motukairangi	Motukairangi	motu: island; kairangi: wonderful, chief, or wandering	Wonderful island
Motukaraka	Motukaraka	motu: clump of trees; karaka: native tree	Clump of karaka trees
Motukāranui	Motukāranui	Motu: island; karā: basalt; nui: large	Island of large basalt stone
Motukauatiiti	Motukauatiiti	motu: grove of trees; kauati: rubbing stick for firemaking; iti: little	Little clump of trees used for fire sticks
Motukauatirahi	Motukauatirahi	motu: grove of trees; kauati: rubbing stick for firemaking; rahi: large	Large clump of trees used for fire sticks
Motukauri: Motukauri Island	Motukauri	motu: island; kauri: native tree	Clump of kauri trees
Motukiekie	Motukiekie	motu: island; kiekie: a native plant	Kiekie island
Motukina	Motukina	motu: island or isolated headland; kina: sea urchin	Kina island
Motukiore	Motukiore	motu: island; kiore: native rat	Rat island
Motukokopu	Motukokopu	motu: island; kokopu: cockabully fish	Cockabully island
Motumāhanga	Motumāhanga	motu: island; māhanga: twin	Twin islands
Motumaire	Motumaire	motu: island; maire: native tree	Maire island
Motumaoho	Motumaoho	motu: clump of trees; maoho: to intrude	Intruding clump of trees
Motunau	Motunau	motu: island; nau: scurvy grass	Scurvy grass island
Motungārara	Motungārara	motu: island; ngārara: lizard	Lizard island
Motunui	Motunui	motu: island; nui: large	Large island
Motuoapa	Motuoapa	motu: island or grove of trees; o: of; Apa	Grove of trees belonging to Apa
Motu-o-Kura	Motu-o-Kura	motu: island; o: of; Kura	Island of Kura
Motuopuhi: Motuopuhi Island	Motuopuhi	motu: island; o: of; Puhi	Island of Puhi
Motuoroi: Motuoroi Island	Motuoroi	motu: island; o: of; Roi	Island of Roi
Motuotaraia	Motuotaraia	motu: isolated area; o: of; Taraia	Isolated area of Taraia
Motupipi	Motupipi	motu: island; pipi: common edible shellfish	Pipi island
Motupiu	Motupiu	motu: island; piu: to swing	Swinging island
Moturoa	Moturoa	motu: island; roa: long	Long island
Motutaiko	Motutaiko	motu: island; taiko: petrel	Island of the black petrel
Motutapu: Motutapu Island	Motutapu	motu: island; tapu: sacred or forbidden	Sacred island
Motutara: Motutara Island	Motutara	motu: island; tara: gull	Gull island
Motutawa	Motutawa	motu: island; tawa: a tree	Tawa tree island
Motutere	Motutere	motu: island; tere: to float	Floating island
Muritai	Muritai	muri: breeze; tai: sea or tide	Sea breeze
Muriwai	Muriwai	muri: end; wai: water	Waters’ end
Ngākawau	Ngākawau	ngā: the; kauwau: shags	The shags
Ngāmatapōuri	Ngāmatapōuri	ngā: the; matapōuri: black teal	The black teals
Ngāmoko	Ngāmoko	ngā: the; moko: lizards	The lizards
Ngāmotu	Ngāmotu	ngā: the; motu: islands	The islands
Ngāpōhatu	Ngāpōhatu	ngā: the; pōhatu: rocks	The rocks
Ngāpuhi	Ngāpuhi	ngā: the; puhi: plumes	The plumes
Ngāpuna	Ngāpuna	ngā; the; puna: springs	The springs
Ngārimu Bay	Ngārimu Bay	ngā: the; rimu: native tree	The rimu trees
Ngāroma	Ngāroma	nga: the; roma: currents	The currents
Ngaionui	Ngaionui	ngaio: a native tree; nui: large or many	Great ngaio tree
Ngāpuke	Ngāpuke	ngā: the; puke: hills	The hills
Ngāroto	Ngāroto	ngā: the; roto: lakes	The lakes
Ngātira	Ngātira	ngā; the; tira: parties of travellers	The parties of travellers
Ngātuku	Ngātuku	ngā: the; tuku: ridges of a hill	The ridges of a hill
Ngāūranga	Ngāūranga	ngā: the; ūranga: landing place for canoes	The landing place for canoes
Ngāurukehu	Ngāurukehu	ngā: the; urukehu: red-haired, fair-skinned Māori	The red-haired, fair-skinned Māori
Ngāwaka	Ngāwaka	ngā: the; waka: canoes	The canoes
Ngāwaro	Ngāwaro	ngā: the; waro: burning coals	The burning coals
Ngāwhā	Ngāwhā	ngāwhā: hot springs	The hot springs
Ngāwhatu	Ngāwhatu	ngā: the; whatu: eyes	The eyes
Ngāwī	Ngāwī	ngā: the; wī: native tussock grass	The native tussock grass
Ngutunui	Ngutunui	ngutu: lip; nui: big	Big lips
Nukumānia	Nukumānia	nuku: wide extent; mānia: plains	Wide plains
Nukuroa	Nukuroa	nuku: to move; roa: long	Long travles
Ōamaru	Ōamaru	ō: place; a: of; Maru	The place of Maru
Ōaonui	Ōaonui	ō: place of; ao: clouds: nui: many	Place of many clouds
Ōaro	Ōaro	ō: place of; aro: front	Front-facing place
Ōeo	Ōeo	ō: place of; eo: louse or lice	Place of lice
Ōhaeawai	Ōhaeawai	ō: place of; haeawai: thermal waters	Place of thermal waters
Ōhakune	Ōhakune	ō: place of; hakune: to be careful	Place of care
Ōhāngai	Ōhāngai	ō: place of; hāngai: opposite, across, or at right angles	Opposite place
Ōhau	Ōhau	ō: place of; Hau	Place of Hau
Ōhauiti	Ōhauiti	ō: place of; hau: wind; iti: little	Place of little wind
Ōhaupō	Ōhaupō	ō: place of; hau: wind; pō: night	Place of a breeze at night
Ōhawe	Ōhawe	ō: place of; hawe: bend in a river or path	Place of many (river) bends
Ōhikaiti	Ōhikaiti	ō: place of; hika: a rite involving certain incantations; iti: small	The place of small incantations
Ōhikanui	Ōhikanui	ō: place of; hika: a rite involving certain incantations; nui: large	The place of large incantations
Ōhinekura	Ōhinekura	Named after Hinekura	Place of Hinekura
Ōhinepanea	Ōhinepanea	ō: place of; Hinepanea: probably a personal name	Place of Hinepanea
Ōhinerau	Ōhinerau	ō: place of; Hinerau, the goddess of whirlwinds	Place of Hinerau
Ōhinerehia	Ōhinerehia	ō: place of; Hinerehia, a legendary creature or mermaid.	Place of Hinerēhia
Ōhingahape	Ōhingahape	ō: place of; hinga: fall; hape: crooked foot	Place of a slip causing a crooked foot
Ōhiwa	Ōhiwa	ō: place of; hiwa: watchful or alert	Place of alertness
Ōhoka	Ōhoka	ō: place of; hoka: a stake to which a decoy kākā (parrot) was tied. Earlier spelt Hohoka	Place of the stake for a decoy parrot
Ōhope	Ōhope	ō: place of; hope (or ope): main body of an army	Place of main body of an army
Ōhotu	Ōhotu	ō: place of; hotu: fifteenth night of the moon	Place of fifteenth night of the moon
Ōhoukākā	Ōhoukākā	ō: place of; hou: feather; kākā: parrot	Place of the parrot feather
Ōhura	Ōhura	ō: place of; hura: to uncover, or uncovered spot	Place which is uncovered
Ōihi	Ōihi	ō: place of; ihi: power or authority	Place of spiritual power
Ōio	Ōio	ō: place of; io: spur	Place of the spur
Ōkahu	Ōkahu	ō: place of; Kahu	Place of Kahu
Ōkahukura	Ōkahukura	ō: place of; Kahukura: atua related to rainbow	Place of Kahukura
Ōkahutai	Ōkahutai	ō: place; kahu: garment; tai: tide	Place of cloaking waters
Ōkaihae	Ōkaihae	ō: place of; kai: food; hae: to dislike	Place of disliked food
Ōkaihau	Ōkaihau	ō: place of; kai: to eat or food; hau: wind	Place of feast of the winds
Ōkarae	Ōkarae	ō: place of; karae: a seabird	Place of the seabird
Ōkarahia	Ōkarahia	ō: place of; karahia: assistance called for in war, in this case in vain	Place of a call for assistance
Ōkareka	Ōkareka	ō: food for a long journey; kareka: sweet or tasty	Sweet food for a long journey
Ōkārito	Ōkārito	ō: place of; karito: young shoots of the bulrush or raupō	Place of young shoots of the bulrush
Ōkataina	Ōkataina	ō: place of; kataina: laughter	Place of laughter
Ōkato	Ōkato	ō: place of; Kato: a personal name	Place of Kato
Ōkau	Ōkau	ō: place of; kau: to swim	Place of swimming
Ōkauia	Ōkauia	ō: place of; kauia: articles threaded on string or on a stick	Place of articles threaded on a stick
Ōkawa	Ōkawa	ō: place of; kawa: bitter	Place of bitter (water)
Ōkehu	Ōkehu	ō: place of; Kehu: a personal name	Place of Kehu
Ōkere	Ōkere	ō: place of; kere: to drift or float	Place of drifting
Ōkete	Ōkete	ō: place of; kete: basket	Place of baskets
Ōkiato	Ōkiato	ō: place of; kīato: a receptacle for holding sacred objects	Place of receptable for holding sacred objects
Ōkiwi	Ōkiwi	ō: place of; kiwi: native bird	Place of the kiwi
Ōkiwi	Ōkiwi	ō: place of; Kiwi	Place of Kiwi
Ōkoki	Ōkoki	ō: place of; koki: a small canoe	Place of a small canoe
Ōkoroire	Ōkoroire	ō: place of; koroire: ring-necked native duck, now extinct	Place of the koroire duck
Ōkōtuku	Ōkōtuku	ō: place of; kōtuku: white heron	Place of the white heron
Ōkupu	Ōkupu	ō: place of; kupu: message	Place of a message
Ōkura	Ōkura	ō: place; kura: red	Place of red (clay)
Ōkuri	Ōkuri	ō: place of; kurī: Polynesian dog	Place of the Polynesian dog
Ōmaha	Ōmaha	ō: place of; maha: pleasure	Place of pleasure
Ōmahu	Ōmahu	ō: place of; ō: provisions for a travelling party; Mahu: a personal name	The place where Mahu ran out of food.
Ōmāio	Ōmāio	ō: place of; māio: calm	Place of calm
Ōmaka	Ōmaka	ō: place of; maka: South island form of manga (stream)	Place of the stream
Ōmakau	Ōmakau	ō: place of; makau: spouse	Belonging to husband and wife
Ōmakere	Ōmakere	ō: place of; makere: to be lost, abandoned or to die	Place of abandonment
Ōmāmari	Ōmāmari	ō: place of; Māmari: a famous canoe that come from Hawaiki.	Place of Māmari canoe
Ōmana	Ōmana	ō: place of; Mana: a personal name	Place of Mana
Ōmanaia	Ōmanaia	ō: place of; Manaia: a personal name	Place of Manaia
Ōmanawa	Ōmanawa	ō: place of; Manawa: a personal name	Place of Manawa
Ōmanawanui	Ōmanawanui	ō: place of; manawanui: stout-hearted, long-suffering or forbearing	Place of unswerving dedication
Ōmāpere	Ōmāpere	ō: place of; māpere: cutty grass	Place of cutty grass
Ōmarama	Ōmarama	ō: place of; Marama: a personal name	Place of Marama
Ōmaru	Ōmaru	ō: place of; maru: shelter	Place of shelter
Ōmarumutu	Ōmarumutu	ō: place of; maru: shade or shelter; mutu: cut off or terminated	Place of cut-off shelter
Ōmarunui	Ōmarunui	ō: place of; maru: shade; nui: great or much	Place of great shade
Ōmarupāpaku	Ōmarupāpaku	ō: place of; maru: shade; pāpaku: shallow	Place of shallow shade
Ōmaui	Ōmaui	ō: place of; Māui	Place of Māui
Ōmihi	Ōmihi	ō: place of; mihi: greeting; also possibly wailing or lamentation	Place of greeting
Ōmimi	Ōmimi	ō: place o; mimi: urine	Place of urine
Ōmoana	Ōmoana	ō: place of; moana: ocean	Place of the sea
Ōmoeroa	Ōmoeroa	ō: place of; moe: sleep; roa: long	Place of the long sleep
Ōnaeroa	Ōnaeroa	ō: place of; naeroa: mosquitoes	Place of mosquitoes
Ōnawe	Ōnawe	ō: place of; nawe: to set on fire	Place of arson
Ōnehunga	Ōnehunga	ō: place of; nehunga: burial	Place of burial
Ōnekakā	Ōnekakā	one: sand; kākā: hot	Hot sand
Onekawa	Onekawa	one: sand; kawa: bitter or sour	Salty soil
Ōnekeneke	Ōnekeneke	ō: place of; nekeneke: to move gradually	Place of movement
Onemaewao	Onemaewao	one: sand; Maewao: fairy-like beings	Place of the Maewao (fairy-like beings)
Oneone	Oneone	oneone: earth, soil	Earth
Onepoto	Onepoto	one: beach; poto: short	Short beach
Onepū	Onepū	one: sand; pū: loose	Loose sandy soil
Onepunui	Onepunui	one: sand; pupuni: covered, fill up	Extensive sand dune
Onerahi	Onerahi	one: beach; rahi: long or wide	Long beach
Oneriri	Oneriri	one: beach; riri: combat, battle, fight, to quarrel or be angry	Battle beach
Oneroa	Oneroa	one: sand or beach; roa: long	Long beach
Onetahua	Onetahua	one: sand; tahua: heaped up	Heaped-up sand (sand dunes)
Onetangi	Onetangi	one: sandy beach; tangi: to weep or to sound	Beach of weeping
Onetapu	Onetapu	one: sand or in this case, desert; tapu: sacred or forbidden	Sacred desert
Onetea	Onetea	one: sandy soil; tea: light-coloured	Light soil
Onewhero	Onewhero	one: soil; whero: red	Red soil
Ōngāroto	Ōngāroto	ō: place of; ngā: the; roto: lakes	Place of the lakes
Ōngāruānuku	Ōngāruānuku	ō: place; ngā; the; ruānuku: learned people	Place of the learned people
Ōngarue	Ōngarue	ō: place of; ngarue: to shake, as in an earthquake	Place of shaking
Ōngātoro	Ōngātoro	ō: place of; Ngātoro: personal name	The place of Ngātoro
Ōnoke	Ōnoke	ō: place of; noke: earthworm	Place of earthworms
Ōnuku	Ōnuku	ō: place of; nuku: food for a journey	Place of Nuku
Ōpaheke	Ōpaheke	ō: place of; paheke: slip or landslide	Place of a landslide
Ōpaki	Ōpaki	ō: place of; paki: fine weather	Place of fine weather
Ōpakū	Ōpakū	ō: place of; pakū: to make a sudden sound or report, to resound or to knock	Place of sudden noise
Ōpanuku	Ōpanuku	ō: place of; Panuku: a personal name	Place of Panuku
Ōpapa	Ōpapa	ō: place of; papa: flat land	Place of flat land
Ōpara	Ōpara	ō: place of; para: mud or dust, or a place where sacred ceremonies were performed	Place of mud
Ōpararā	Ōpararā	ō: place of; parara: to lie open towards	A place which lies open (to the Tasman Sea)
Ōparau	Ōparau	ō: place of; pa: fortified villages; rau: many; or parau: dissembling or falsehood	Place of many fortified villages; or Place of falsehood
Ōpārure	Ōpārure	ō: place of; pārure: to plunder	Place of plunder
Ōpepe	Ōpepe	ō: place of; pepe: moth	Place of the moth
Ōpihi	Ōpihi	ō: place of; pihi: springing up (referring to plants)	Place of springing-up (plants)
Ōpiki	Ōpiki	ō: place of; piki: to climb or ascend	Place of climbing
Ōpito	Ōpito	ō: place of; pito: umbilical cord	Place of umbilical cords
Ōpoe	Ōpoe	ō: place of; Poe	Place of Poe
Ōpoho	Ōpoho	ō: place of; Poho	Place of Poho
Ōpononi	Ōpononi	ō: place of; pou: post; noni: crooked	Place of crooked fishing post
Ōpōuri	Ōpōuri	ō: place of; pōuri: sadness	Place of sadness
Ōpoutama	Ōpoutama	ō: place of; poutama: pattern on the tukutuku panels of a whare	Place of the poutama pattern
Ōpoutere	Ōpoutere	ō: place of; pou: pour out; tere: quickly	The place (where the sea-waters) swiftly empty out
Ōpua	Ōpua	ō: place of; pua: flower	Place of the flower
Ōpuke	Ōpuke	ō: place of; puke: hill	Place of the hill
Ōrākau	Ōrākau	ō: place of; rakau: trees	Place of trees
Ōrākei	Ōrākei	ō: place of; rākei: adornment	Place of adornment
Ōrakei Kōrako	Ōrakei Kōrako	ō: place of; rakei: adornment; kōrako: white	Place of adornment near the white (sinter flat)
Ōranga	Ōranga	ō: place of; ranga: rising ground, hill, sandbank, or fishing ground	Place of rising ground
Ōrarī	Ōrarī	ō: place of; rarī: butterfish	Place of the butterfish
Ōrātia	Ōrātia	ō: place of; ra: sun; tia: persistency	Place of long-lingering sun
Ōrere	Ōrere	ō: place of; rere: waterfall	Place of the waterfall
Ōreti	Ōreti	ō: place of; reti: snare	Place of the snare
Ōringi	Ōringi	ō: place of; Ringi	Place of Ringi
Ōrongo	Ōrongo	ō: place of; rongo: listening-post	Place of the listening post
Ōrongorongo	Ōrongorongo	o: of; rongorongo: a woman’s name	Place of Rongorongo
Ōropi	Ōropi	ō: place of; ropi: to cover up	Place of covering up
Ōroua	Ōroua	ō: place of; roua: dredging for shellfish	Place of dredging for shellfish
Ōruaiti	Ōruaiti	ō: place of; rua: pit; iti: small	Place of small pit
Ōruanui	Ōruanui	ō: place of; rua: pit; nui: large or many	Place of many pits
Ōruawairua	Ōruawairua	ō: place of; rua: two; wairua: soul or spirit	Meeting-place of spirits
Ōruawharo	Ōruawharo	ō: place of; rua: hole or pit; whārō: stretched out in full length	Place of stretched-out pit
Ōruawharo	Ōruawharo	ō: place of; Ruawharo: a personal name	Place of Ruawharo
Ōrukuwai	Ōrukuwai	ō: place of; Rukuwai: a personal name	Place of Rukuwai
Ōruru	Ōruru	ō: place of; ruru: morepork	Place of the morepork
Ōrurutūmārō	Ōrurutūmārō	ō: place of; ruru: morepork; tū: stand; mārō: firm	Place of the unmoving morepork
Ōtāhei	Ōtāhei	ō: place of; tāhei: a bird snare	Place of the bird snare
Ōtahu	Ōtahu	ō: place of; Tahu: a personal name	Place of Tahu
Ōtāhūhū	Ōtāhūhū	ō: place of tāhūhū: ridgepole of a house	Place of the ridgepole of a house
Ōtaihanga	Ōtaihanga	ō: place of: Taihanga: a personal name	Place of Taihanga
Ōtāika	Ōtāika	ō: place of; tāika: to lie in a heap	Place of lying in a heap
Ōtakapuneke	Ōtakapuneke	ō: place of; Takapuneke: a personal name	Place of Takapuneke
Ōtakaro	Ōtakaro	ō: place of; Takaro: a personal name	Place of Takaro
Ōtakeho	Ōtakeho	ō: place of; Takeho: a personal name	Place of Takeho
Ōtaki	Ōtaki	ō: place of; taki: stick in	Place of sticking a staff into the ground
Ōtākiri	Ōtākiri	ō: place of; tākiri: loosening or making free from tapu	Place of loosening or freeing from tapu
Ōtakou	Ōtakou	ō: place of; tākou: red ochre	Place of red ochre; or place of Tākou
Ōtama	Ōtama	ō: place of;  Tama: a personal name	Place of Tama
Ōtamakura	Ōtamakura	ō: place of; tama: son; kura: ornamented with red feathers	Place of boy ornamented with red feathers
Ōtamarākau	Ōtamarākau	ō: place of; tama: young men; rākau: weapons	Place of young warriors
Ōtamarau	Ōtamarau	ō: place of; Tamarau: a personal name	Place of Tamarau
Ōtamatea	Ōtamatea	ō: place of; Tamatea: a personal name	Place of Tamatea
Ōtāne	Ōtāne	ō: place of; tāne: man	Place of a man
Ōtāngarei	Ōtāngarei	ō: place of; tanga: row or company of people; rei: leaping	Place of group of people leaping
Ōtangaroa	Ōtangaroa	ō: place of; Tangaroa: a personal name, or the god of the ocean	Place of Tangaroa
Ōtangihaku	Ōtangihaku	ō: place of; tangi: to sound or weep; haku: to murmur	Place of murmured weeping
Ōtangimoana	Ōtangimoana	ō: place of; tangi: weeping; moana: waters	Place of weeping waters
Ōtangiwai	Ōtangiwai	ō: place of; tangi: weeping; wai: waters	Place of weeping waters
Ōtāpara	Ōtāpara	ō: place of; tāpara: desire, or wooden digging implement	Place of digging implement
Ōtāpiri	Ōtāpiri	ō: place of; tapiri: a vigorous shoot growing beside the main stem of a plant	Place of vigorous growing shoot
Ōtara	Ōtara	ō: place of; tara: peak	Place of the peak
Ōtara	Ōtara	ō: place of; Tara: a personal name	Place of Tara
Ōtaraia	Ōtaraia	ō: place of; Taraia: a personal name	Place of Taraia
Ōtaranga	Ōtaranga	ō: place of; taranga: separation	Place of separation
Ōtatara	Ōtatara	ō: place of; tatara: to untie or loosen	Place of loosening
Ōtauaki	Ōtauaki	ō: place of; tauaki: to show or expose	Place of exposure
Ōtautau	Ōtautau	ō: place of; tautau: greenstone ear pendant with a straight shank curved at the lower end	Place of ear pendant
Ōtāwēwē	Ōtāwēwē	ō: place of: tāwēwē: weighted net	Place of a weighted net
Ōtāwhao	Ōtāwhao	ō: place of; tāwhao: fragments, refuse or brushwood	Place of brushwood scrub
Ōtehei	Ōtehei	ō: place of; te: the; hei: neck ornament	Place of the neck ornament
Ōtehīwai	Ōtehīwai	ō: place of; te: the; hīwai: springing up	Place of springing up of water
Ōtekura	Ōtekura	ō: place of; te: the; kura: red feather	Place of the red feather
Ōtepopo	Ōtepopo	ō: place of; te: the; popo: decayed wood	Place of the decayed wood
Ōtipua	Ōtipua	ō: place of; tipua: enchanted object or person	Place of supernatural creature
Ōtiria	Ōtiria	ō: place of; tiria: to be planted	Place of planting
Ōtiwhā	Ōtiwhā	ō: place of: tiwhā: a patch of shell or wood to cover a hole in a kelp bag	Place of patch
Ōtoatahi	Ōtoatahi	ō: place of; toa: warrior; tahi: one	Place of a single warrior
Ōtohi	Ōtohi	ō: place of; tohi: ritual ceremony	Place of ceremony
Ōtoko	Ōtoko	ō: place of; toko: stick or staff	Place of the staff
Ōtonga	Ōtonga	ō: place of; tonga: south, or south wind	Place of the south wind
Ōtoroa	Ōtoroa	ō: place of; toroa: albatross	Place of the albatross
Ōtūkapuarangai	Ōtūkapuarangai	ō: place of; tu: to stand; kapua: cloud; rangi: sky	Place of the standing cloud in the sky
Ōtūmatua	Ōtūmatua	o: place of; tū: stand; matua: parent	Where the elder stands
Ōtūmoetai	Ōtūmoetai	ō: place of; tu: to stand; moe: to sleep; tai: tide	Place where the tide stands still as if asleep
Ōtūpaopao	Ōtūpaopao	ō: place of; tū: to stand; paopao: to break by repeated strokes	Place of standing and breaking
Ōtūraki	Ōtūraki	ō: place of; tū: to stand; raki (rangi): sky	Place of standing in the sky
Ōtūrēhua	Ōtūrēhua	ō: place of; tū: to stand; Rēhua: the star Antares	Place where the summer star stands still
Ōturoto	Ōturoto	ō: place of; Turoto: a personal name	Place of Turoto
Ōtūru	Ōtūru	ō: place of; Turu: a personal name	Place of Turu
Ōue	Ōue	ō: place of; Ue: a personal name	Place of Ue
Ōueroa	Ōueroa	ō: place of; ue: species of flax; roa: long	Place of long flax
Ōui	Ōui	ō: place of; ui: to ask	Place of questioning
Ōuruhia	Ōuruhia	ō: place of; uruhia: to be attacked	Place of being attacked
Ōwahanga	Ōwahanga	ō: place of; wahanga: burden	Place of burden
Ōwairaka	Ōwairaka	ō: place of; Wairaka, a chieftainess of repute	Place of Wairaka
Ōwairaka	Ōwairaka	ō: place of; wai: stream; Raka: an ancestor	Place of the stream of Raka
Ōwaka	Ōwaka	ō: place of; waka: canoe or wooden trough	Place of a canoe
Ōweka	Ōweka	ō: place of; weka: wood-hen	Place of the weka
Ōwhango	Ōwhango	ō: place of; whango: hoarse voice or wheezy sound	Place of wheezy noises
Ōwhata	Ōwhata	ō: place of; whata: elevated stage to protect food from bush rats, and for drying	Place of the elevated stage
Ōwhawhe	Ōwhawhe	ō: place of; whawhe: put round	The place encircled
Ōwhiro	Ōwhiro	ō: place of; Whiro	Place of Whiro
Paehinahina	Paehinahina	pae: ridge, headland; hinahina: a small tree also knwn as mahoe	Hinahina ridge
Paekākāriki	Paekākāriki	pae: perch or snare; kākāriki: parakeet (Cyanoramphus novaezelandiae)	Parakeet perch
Paekoka	Paekoka	pae: ridge; koka: an unidentified species of seabird that was caught here	Seabird ridge
Paeoterangi	Paeoterangi	pae: perching place; o: of; te: the; rangi: sky	Footstool of the sky
Paerātā	Paerātā	pae: ridge; rātā: native tree	Ridge of the rātā tree
Paerau	Paerau	pae: ridges or steps; rau: many or a hundred	Many ridges
Paeroa	Paeroa	pae: ridge of hills; roa: long	Long ridge of hills
Paetiki	Paetiki	pae: ridge; tiki: carved wooden or stone figure	Ridge of carved figure
Pakirārahi	Pakirārahi	pakirā: bald; rahi: big	Large bald dome
Papahīnau	Papahīnau	papa: flat; hīnau: native tree	Hīnau flats
Papaiti	Papaiti	papa: flat; iti: small	Small flats
Papakaio	Papakaio	papa: flat; kaio: native tree (South Island form of ngaio)	Kaio tree flats
Papakura	Papakura	papa: flat; kura: red	Red flats
Papamoa	Papamoa	papa: flat; moa: raisted mounds for growing vegetables	Raised mounds for growing vegetables on the flats
Papanui	Papanui	papa: flat; nui: large	Large flat
Paparangi	Paparangi	papa: flat; rangi: sky	Flat sky
Paparātā	Paparātā	papa: flat; rātā: native tree	Rātā tree flats
Paparimu	Paparimu	papa: flat; rimu: native tree	Rimu tree flats
Paparoa	Paparoa	papa: flat; roa: long	Long flats
Papatawa	Papatawa	papa: flat; tawa: native tree	Tawa tree flats
Papatāwhara	Papatāwhara	papa: ground; tāwhara: kiekie flowers	Kiekie flower flats
Papatoetoe	Papatoetoe	papa: flat; toetoe: native grass	Toetoe grass flat
Papatōtara	Papatōtara	papa: flat; tōtara: native tree	Tōtara flat
Papatōwai	Papatōwai	papa: flat; tōwai: native tree	Tōwai tree flat
Papawai	Papawai	papa: flat; wai: water	Inundated land
Pāreranui	Pāreranui	pārera: grey duck (Anas superciliosa): nui: large	Large grey duck
Paretai	Paretai	pare: divert; tai: the tide	River bank
Paretetaitonga	Paretetaitonga	para: dust; te: the; tai: sea; tonga: south	The dust from the south sea
Pārewanui	Pārewanui	pā: fortified village; rewa: swamp; nui: large	Fortified village in a large swamp
Pari-nui-te-ra	Pari-nui-te-ra	pari: cliff; nui: great; te: the; rā: sun	Great cliff in the sun
Pariparitetai	Pariparitetai	paripari: cliffs; te: the; tai: coast	Cliffs on the coast
Pariroa	Pariroa	pari: cliff; roa: long	Long cliff
Pāroa	Pāroa	pā: fortified village; roa: long, broad	Broad fortified village
Paruroa	Paruroa	paru: mud; roa: long	Long mud
Paturoa	Paturoa	patu: to strike or kill; roa: long	Much hitting
Pāuanui	Pāuanui	pāua: shellfish; nui: many or large	Many or large pāua
Pikowai	Pikowai	piko: corner or bend; wai: stream	Bend in the stream
Pipiroa	Pipiroa	pipi: cockle; roa: long	Long pipi
Pīroa	Pīroa	pī: headwaters; roa: long	Long headwaters
Pōhatunui	Pōhatunui	pōhatu: rock; nui: great	Great rock
Pōhaturoa	Pōhaturoa	pōhatu: rock; roa: tall	Tall rock
Pohonui	Pohonui	poho: stomach; nui: big	Big stomach
Pōhuenui	Pōhuenui	pōhue: convolvulus or other climbing plants; nui: many	Large climbing plant
Pongaroa	Pongaroa	ponga: tree fern; roa: tall or long	Tall tree fern
Pōnui	Pōnui	pō: night; nui: long	Long night
Puatai	Puatai	pua: foam; tai: sea	Foam of the sea
Pukearuhe	Pukearuhe	puke: hill; aruhe: bitter	Hill of bitterness
Puhinui	Puhinui	puhi: plume at the bow of a war canoe; nui: large	Large plume at bow of war canoe
Pukeatua	Pukeatua	puke: hill; atua: god	Hill of the deity
Pukehinau	Pukehinau	puke: hill; hinau: a native tree	Hīnau tree hill
Puke-hiwi-tahi	Puke-hiwi-tahi	puke: hill; hiwi: ridge; tahi: one	One-ridge hill
Pukehuhu	Pukehuhu	puke: hill; huhu: grub	Huhu grub hill
Pukehuia	Pukehuia	puke: hill; huia: cluster	Cluster of hills
Pukeiti	Pukeiti	puke: hill; tī: cabbage tree	Cabbage tree hill
Pukekāhu	Pukekāhu	puke: hill; kāhu: hawk	Hill of the hawk
Pukekaikiore	Pukekaikiore	puke: hill; kai: to eat; kiore: rat	Hill of the eaten rat
Pukekākāriki	Pukekākāriki	puke: hill; kākāriki: parakeet	Hill of the parakeet
Pukekāpia	Pukekāpia	puke: hill; kāpia: kauri gum	Kauri gum hill
Pukekoikoi	Pukekoikoi	puke: hill; koikoi: pointed	Pointed hill
Pukekōmā	Pukekōmā	puke: hill; kōmā: light-coloured or bright; or a kind of stone	Light-coloured hill
Pukekōwhai	Pukekōwhai	puke: hill; kōwhai: native tree	Kōwhai tree hill
Pukekura	Pukekura	puke: hill; kura: red	Red hill
Puke-māeroero	Puke-māeroero	puke: hill; māeroero: ogres of the forest	Hill of ogres
Pukemaori	Pukemaori	puke: hill; māori: Māori	Māori hill
Pukemarama	Pukemarama	puke: hill; marama: moon	Moon hill
Pukemātāwai	Pukemātāwai	puke: hill: mātāwai: source of streams	Hill is source of stream
Pukematekeo	Pukematekeo	puke: hill; mate: end; keo: peak	The hill at the end of the range
Pukemiro	Pukemiro	puke: hill; miro: native tree	Miro tree hill
Pukemoko	Pukemoko	puke: hill; moko: tattoo	Hill of tattoos
Pukemoremore	Pukemoremore	puke: hill; more; a freshwater fish	Hill of many pinbellied freshwater fish
Pukengahu	Pukengahu	puke: hill; ngahu: point or promontory	Hill
Pukenui	Pukenui	puke: hill; nui: large	Large hill
Pukeokahu	Pukeokahu	puke: hill; o: of; Kahu: personal name	Hill of Kahu
Puke-o-Tara	Puke-o-Tara	puke: hill; o: of; Tara	Hill of Tara
Pukepiripiri	Pukepiripiri	puke: hill; piripiri: the ‘biddy-bid’ (Acaena anserinifolia)	‘Biddy-bid’ hill
Pukepito	Pukepito	puke: hill; pito: end	Hill end
Pukepōhatu	Pukepōhatu	puke: hill; pōhatu: rock	Rock hill
Pukepoto	Pukepoto	puke: hill; poto: dark blue earth present in a nearby swamp, used as a pigment	Dark blue pigment hill
Pukerangi	Pukerangi	puke: hill; rangi: sky	Sky hill
Pukerangiora	Pukerangiora	puke: hill; rangiora: native shrub	Rangiora shrub hill
Pukerau	Pukerau	puke: hills; rau: a leaf, a hundred or many	Hill of leaves
Pukerauaruhe	Pukerauaruhe	puke: hill; rauaruhe: bracken fronds	Hill of bracken fronds
Pukerimu	Pukerimu	puke: hill; rimu: native tree	Rimu tree hill
Pukeora	Pukeora	puke: hill; ora: well or in good health	Hill of good health
Pukeroa	Pukeroa	puke: hill; roa: long or tall	Tall hill
Pukerua	Pukerua	puke: hill; rua: two	Two hills
Puketaha	Puketaha	puke: hill; taha: side	Hill side
Puketāpapa	Puketāpapa	puke: hill; tāpapa: edge or flat-topped	Flat-topped hill
Puketapu	Puketapu	puke: hill; tapu: sacred or forbidden	Sacred hill
Puketawa	Puketawa	puke: hill; tawa: native tree	Tawa tree hill
Puketī	Puketī	puke: hill; tī: cabbage tree	Cabbage tree hill
Puketihi	Puketihi	puke: hill; tihi: top or summit	Summit of the hill
Puketiro	Puketiro	puke: hill; tiro: view	View from the hill
Puke-tirohia-marama	Puke-tirohia-marama	puke: hill; tirohia: to survey or view; marama: moon	Hill giving a view of the moon
Puketoi	Puketoi	puke: hill; toi: summit	Summit of the hill
Puketōtara	Puketōtara	puke: hill; tōtara tree	Tōtara hill
Puketūī	Puketūī	puke: hill; tūī: native bird	Tūī hill
Puketūroto	Puketūroto	puke: hill; tū: to stand; roto: lake	Hillside beside the lake
Puketutu	Puketutu	puke: hill; tutu: native shrub (Coriaria arborea)	Tutu shrub hill
Pukewhau	Pukewhau	puke: hill; whau: a native tree	Whau tree hill
Pukewhero	Pukewhero	puke: hill; whero: red	Red hill
Pukurahi	Pukurahi	puku: belly; rahi: large	Large belly
Rāhotu	Rāhotu	rā: sun; hotu: to long for	Long for the sun
Rākaunui	Rākaunui	rākau: tree; nui: many or large	Many trees
Rākauroa	Rākauroa	rākau: tree; roa: tall	Tall trees
Ramaroa	Ramaroa	rama: torch; roa: long	Long torch
Ranganui	Ranganui	ranga: parade; nui: large	Large parade
Rangi-roa	Rangi-roa	rangi: sky; roa: long	Long sky
Rānui	Rānui	rā: sun; nui: many	Plenty of sunshine
Rapanui	Rapanui	rapa: there are many meanings of rapa, including to seek; nui: many	Much seeking
Rārangi-roa	Rārangi-roa	rārangi: line or row; roa: long	Long line
Rāroa	Rāroa	rā; day; roa: long	Long day
Rātānui	Rātānui	rātā: native tree; nui: large or many	Many or large rātā trees
Rāwhitiroa	Rāwhitiroa	rā: sun; whiti: to shine; roa: long	Long-shining sun
Reporoa	Reporoa	repo: swamp; roa: long or wide	Long swamp
Rimunui	Rimunui	rimu: native tree; nui: many or large	Many or large rimu trees
Rongotai	Rongotai	rongo: sound; tai: sea	Sound of the sea
Rotoaira	Rotoaira	roto: lake; a: of; Ira	Lake of Ira
Roto-a-Tara	Roto-a-Tara	roto: lake; a: of; Tara	Lake of Tara
Rotoehu	Rotoehu	roto: lake; ehu: turbid	Turbid lake
Rotoiti	Rotoiti	roto: lake; iti: small	Little lake
Rotokākahi	Rotokākahi	roto: lake; kākahi: freshwater shellfish	Freshwater shellfish lake
Rotokauri	Rotokauri	roto: lake; kauri: native tree	Kauri tree lake
Rotokawa	Rotokawa	roto: lake; kawa; bitter	Bitter lake
Rotokawau	Rotokawau	roto: lake; kawau: shag	Shag lake
Rotokohu	Rotokohu	roto: lake; kohu: mist	Misty lake
Rotokura	Rotokura	roto: lake; kura: red	Red glow of sunset on the water
Rotoma	Rotoma	roto: lake; ma: clear	Clear lake
Rotomahana	Rotomahana	roto: lake; mahana: warm	Warm lake
Rotomanu	Rotomanu	roto: lake; manu: bird	Bird lake
Rotongaro	Rotongaro	roto: lake; ngaro: hidden or lost	Hidden lake
Roto-o-rangi	Roto-o-rangi	roto: lake; o: of; rangi: sky	Lake of the sky
Rotoroa	Rotoroa	roto: lake; roa: long	Long lake
Rotorua	Rotorua	roto: lake; rua: two	Two lakes
Rototuna	Rototuna	roto: lake; tuna: eel	Eel lake
Rotowaro	Rotowaro	roto: lake; waro: coal or glowing embers	Lake of glowing embers
Ruapuke Island	Ruapuke	rua: two; puke: hills	Two hill island
Ruaroa	Ruaroa	rua: cave or pit; roa: long	Long pit
Ruawai	Ruawai	rua: hole; wai: water	Watery hole
Rukumoana	Rukumoana	ruku: to dive; moana: sea, or deep pool in river	Diving into the pool
Tāhaenui	Tāhaenui	tāhae: thief; nui: big or many	Many thieves
Taharoa	Taharoa	taha: coast; roa: long	Long coast
Tahawai	Tahawai	taha: side; wai: water	Seaside
Tāhekereroa	Tāhekereroa	tāheke: waterfall; roa: high or long	High waterfall
Tahoraiti	Tahoraiti	tahora: forest clearing; iti: little	Little forest clearing
Tāhuhūnui	Tāhuhūnui	tāhūhū: ridge-pole; nui: large	Large ridge-pole
Tāhunanui	Tāhunanui	tāhuna: shoal or sandbank; nui: large	Large sandbank
Taiharuru	Taiharuru	tai: sea; haruru: resounding	Resounding sea
Taikorea	Taikorea	tai: sea; korea: a small canoe	Tide of the small canoe
Taimate	Taimate	tai: tide; mate: dead	A salt pool blocked off from the tide
Tainui	Tainui	tai: tide; nui: great	Great tide
Tairua	Tairua	tai: tides; rua: two	Two tides
Taitapu	Taitapu	tai: coast; tapu: sacred	Sacred coast
Taitimu	Taitimu	tai: tide; timu: to ebb	Ebb of the tide
Taitomo	Taitomo	tai: sea; tomo: shaft	Shaft of the sea
Takahiwai	Takahiwai	takahi: to trample; wai: water	Trample water
Takutai	Takutai	taku: coast; tai: sea	Sea coast
Tangimoana	Tangimoana	tangi: to weep or lament; moana: ocean	Weeping sea
Tangiwai	Tangiwai	tangi: to cry or weep; wai: water	Weeping water
Taonui	Taonui	tao: spear; nui: many	Large spear
Taoroa	Taoroa	tao: spear; roa: long	Long spear
Tapuwaeroa	Tapuwaeroa	tapuwae: footsteps; roa: long	Long footsteps
Tātuanui	Tātuanui	tātua: girdle; nui: large or many	Large girdle
Taumarunui	Taumarunui	taumaru: screen; nui: large	Large screen
Taumatawhakatangihangakōauauotamateapōkaiwhenuakitanatahu	Taumatawhakatangihangakōauauotamateapōkaiwhenuakitanatahu	taumata: brow of a hill; whakatangihanga: place of sounding or playing; kōauau: flute; o: of; Tamatea-pōkai-whenua; ki: to; tana: his; tahu: lover	The brow of the hill where Tamatea who travelled all over the land played his flute to his lover
Taumoana	Taumoana	tau: to come to rest (and many other meanings); moana: sea	Come to rest at sea
Tauranganui	Tauranganui	taura: landing places; nui: many, great	Great landing place
Tauraroa	Tauraroa	taura: rope; roa: long	Long rope
Tawanui	Tawanui	tawa: native tree (Beilschmiedia tawa); nui: many	Great tawa tree
Tāwharanui	Tāwharanui	tāwhara: flower of the kiekie (Freycinetia banksii); nui: many	Many flowers of the kiekie
Te Araroa	Te Araroa	te: the; ara: path; roa: long	The long path
Te Awa	Te Awa	te: the; awa: valley or channel	The valley
Te Awahou	Te Awahou	te: the; awa: river; hou: new	The new river
Te Awaiti	Te Awaiti	te: the; awa: stream; iti: little	The little stream
Te Awa-māeroero	Te Awa-māeroero	te: the; awa: river; māeroero: ogres of the South Island forests	The river of the ogres
Te Awamutu	Te Awamutu	te: the; awa: river; mutu: cut off or ended	The ended river
Te Awa-parahi	Te Awa-parahi	te: the; awa: valley; parahi: steep	The steep valley
Te Awaure	Te Awaure	te: the; awa: river; ure: male	The male river
Te Haehaenga	Te Haehaenga	te: the; haehaenga: torn or lacerated	The laceration
Te Hana	Te Hana	te: the; hana: glow or gleam	The glow
Te Hāpara	Te Hāpara	te: the; hāpara: dawn	The dawn
Te Hāparangi	Te Hāparangi	te: the; hāparangi	The circumstance of shouting
Te Hāpua	Te Hāpua	te: the; hāpua: lagoon	The lagoon
Te Hāroto	Te Hāroto	te: the; hāroto: pool	The pool
Te Henga	Te Henga	te: the; henga: food for a work party	The food for a work party
Te Hēnui	Te Hēnui	te: the; hē: amongst its several meanings are wrong, erring, error, difficulty, trouble; nui: big	The great mistake
Te Ika-a-Māui	Te Ika-a-Māui	te: the; ika: fish; a: of; Māui: a personal name	The fish of Māui
Te Ika-a-Ranganui	Te Ika-a-Ranganui	te: the; ika: fish; a: of; Ranganui: a personal name	The fish of Ranganui
Te Horo	Te Horo	te: the; horo: landslide	The landslide
Te Kaha	Te Kaha	te: the; kaha: rope	The rope
Te Kao	Te Kao	te: the; kao: dried kūmara	The dried kūmara
Te Kauwhata	Te Kauwhata	te: the; kau: empty; whata: storehouse	The empty storehouse
Te Kawakawa	Te Kawakawa	te: the; kawakawa: a native shrub	The kawakawa shrub
Te Kōpua	Te Kōpua	te: the; kōpua: deep pool	The deep pool
Te Kiri	Te Kiri	te: the; kiri: bark	The bark
Te Kōhanga	Te Kōhanga	te: the; kōhanga: nest	The nest
Te Kōwhai	Te Kōwhai	te: the; kōwhai: a tree	The kōwhai tree
Te Mānia	Te Mānia	te: the; mānia: plain	The plain
Te Moana	Te Moana	te: the; moana: ocean	The sea
Te Moana o Toi te Huatahi	Te Moana o Toi te Huatahi	te: the; moana: ocean; o: of; Toi te Huatahi	The ocean of Toi te Huatahi
Te Moananui	Te Moananui	te: the; moana: ocean; nui: large	The great ocean
Te Moananui-a-Kiwa	Te Moananui-a-Kiwa	te: the; moana: ocean; nui: large; a: of; Kiwa	The great ocean of Kiwa
Te Onepū	Te Onepū	te: the; onepū: sand	The sand
Te Onewa	Te Onewa	te: the; one: earth, soil or land; wa: unenclosed country	Soil of the unenclosed land
Te Papatapu	Te Papatapu	te: the; papa: flat; tapu: sacred or forbidden	The sacred flat
Te Puke	Te Puke	te: the; puke: hill	The hill
Te Tai Tamāhine	Te Tai Tamāhine	te: the; tai: sea, coast; tamāhine: daughter, girl	The female coast
Te Tai Tamatāne	Te Tai Tamatāne	te: the; tai: sea, coast; tamatāne: son, body	The male coast
Te Tai o Marokura	Te Tai o Marokura	te: the; tai: sea, coast; o: of; Marokura	The coast of Marokura
Te Tai o Mahaanui	Te Tai o Mahaanui	te: the; tai: sea, coast; o: of; Mahaanui	The coast of Mahaanui
Te Tai o Aorere	Te Tai o Aorere	te: the; tai: sea, coast; o: of; Aorere	The coast of Aorere
Te Tai Poutini	Te Tai Poutini	te: the; tai: sea, coast; Poutini	The coast of Poutini
Te Tukeroa	Te Tukeroa	te: the ; tuke: elbow or bend; roa: tall	The long bend
Te Waharoa	Te Waharoa	te: the; waha: to carry on the back; roa: long	The long carry
Te Wai Pounamu	Te Wai Pounamu	te; the; wai: water; pounamu: greenstone	The greenstone waters
Te Waiiti	Te Waiiti	te: the; wai: stream; iti: small	The little stream
Te Waiopani	Te Waiopani	te: the wai: water; o: of; Pani	The water of Pani
Te Wairoa	Te Wairoa	te: the; wai: river or stream; roa: long	The long stream
Te Waitere	Te Waitere	te: the; wai: water; tere: swiftly flowing	The swift stream
Te Wēiti	Te Wēiti	te: the; wē: water; iti: little	The little water
Te Whare-kai-atua	Te Whare-kai-atua	te: the; whare: house; kai: eat; atua: gods	The abode that consumes deities
Tīkapa Moana	Tīkapa Moana	tīkapa: mournful; moana: sea	The mournful sea
Tikinui	Tikinui	tiki: human representation in wood or stone; nui: large or many	The great human carving
Tinui	Tinui	ti: cabbage tree; nui: large or many	Many cabbage trees
Tiroa	Tiroa	ti: cabbage tree; roa: tall	Long cabbage tree
Tiromoana	Tiromoana	tiro: view; moana: ocean	View the sea
Tironui	Tironui	tiro: view; nui: large or expansive	Expansive view
Tiroroa	Tiroroa	tiro: view; roa: long	Long view
Titiroa	Titiroa	titi: long streaks of cloud; roa: long	Long streaks of cloud
Tokanui	Tokanui	toka: rock; nui: large or many	Large rock
Tokarahi	Tokarahi	toka: rock; rahi: large or many	Many rocks
Tokaroa	Tokaroa	toka: rock; roa: tall or long	Tall rock
Tokoiti	Tokoiti	toko: pole; iti: small	Little pole
Tokoroa	Tokoroa	toko: pole: roa: long	Long pole
Tōmoana	Tōmoana	tō: to drag or as far up as; moana: ocean	Drag to the ocean
Tōtaranui	Tōtaranui	tōtara: trees; nui: many	Many tōtara trees
Tunanui	Tunanui	tuna: eels; nui: many	Many eels
Tūranganui	Tūranganui	tūranga: standing; nui: great	Great standing place
Tūrangaomoana	Tūrangaomoana	tūranga: standing place; o: of; moana: the sea	Resting place of the sea
Tūtaenui	Tūtaenui	tūtae: dung; nui: large	Large dung
Umutaoroa	Umutaoroa	umu: oven; taoroa: long spear	Oven of the long spear
Urenui	Urenui	ure: courage (a figurative expression); nui: great	Great courage
Utuwai	Utuwai	utu: dip into, in order to fill a bowl; wai: water	Dip into water
Waianiwaniwa	Waianiwaniwa	wai: water; aniwaniwa: rainbow	Rainbow waters
Waiapu	Waiapu	wai: water; apu: to swallow	Swallowing river
Waiareka	Waiareka	wai: water; a: of; reka: sweet or sweetness	Sweet water
Waiariari	Waiariari	wai: water; ariari: gleaming or undisturbed	Gleaming water
Waiariki	Waiariki	wai: water; ariki: chief	Waters of the chief
Waiaro	Waiaro	wai: water; aro: wistful	Wistful water
Waiatoto	Waiatoto	wai: water; a: of; toto: blood	Water of blood
Waiau	Waiau	wai: water; au: current	Swirling waters
Waiaua	Waiaua	wai: water; aua: herring	Waters containing herring
Waihaha	Waihaha	wai: water; haha: noisy	Noisy water
Waihakeke	Waihakeke	wai: water; hakeke: wood ear fungus	Wood ear fungus water
Waihao	Waihao	wai: water; hao: to catch in a net	Water of net fishing
Waihao	Waihao	wai: river: hao: a species of small eel	Water with eels
Waihaorunga	Waihaorunga	wai: river: hao: a species of small eel; runga: top or upper part	Water with eels at the top
Waiharakeke	Waiharakeke	wai: stream; harakeke: flax	Flax stream
Waiharuru	Waiharuru	wai: water; haruru: to reverberate or rumble	Rumbling waters
Waihau	Waihau	wai: water; hau: wind	Windy water
Waiheke	Waiheke	wai: water; heke: to ebb, drip or descend	The descending waters
Waihemo	Waihemo	wai: water or stream; hemo: to cease	The finished stream
Waihīnau	Waihīnau	wai: stream; hīnau: a native tree	Hīnau tree stream
Waihīrere	Waihīrere	wai: water; hīrere: to rush	Rushing waters
Waihōaka	Waihōaka	wai: stream; hōaka (South Island form of hōanga): sandstone, used for grinding and polishing greenstone	Water of sandstone
Waihōhepa	Waihōhepa	wai: stream, water; Hohepa: the Maori form of Joseph	The water of Hōhepa
Waihōhonu	Waihōhonu	wai: river; hōhonu: deep	Deep water
Waihopo	Waihopo	wai: river; hopo: to be apprehensive or doubtful	A river one fears to cross
Waihora	Waihora	wai: water; hora: spread out	Spread-out waters
Waihōu	Waihōu	wai: river; hōu: new	New waters
Waihua	Waihua	wai: water; hua: fish roe	Fish roe waters
Waihue	Waihue	wai: river; hue: gourd	River gourd waters
Wai-iti	Wai-iti	wai: stream; iti: little	Little stream
Waikākā	Waikākā	wai: water; kākā: parrot	Parrot stream
Waikākāhi	Waikākāhi	wai: water; kākahi: freshwater shellfish	Waters of freshwater shellfish
Waikākaho	Waikākaho	wai: water; kākaho: flowering plumes of the toetoe	Waters of the flowering plumes of the toetoe
Waikanae	Waikanae	wai: water; kanae: mullet	Mullet waters
Waikaraka	Waikaraka	wai: stream; karaka: native tree	Karaka tree stream
Waikarakia	Waikarakia	wai: stream; karakia: prayer or incantation	Stream of ritual
Waikare	Waikare	wai: water; kare: to ripple	Rippling waters
Waikareiti	Waikareiti	wai: water; kare: to ripple or dash; iti: little	Little waters
Waikaremoana	Waikaremoana	wai: water; kare: to ripple; moana: sea or large lake	Sea of rippling waters
Waikāretu	Waikāretu	wai: water; kāretu: a sweet-scented grass	Waters of the kāretu grass
Waikari	Waikari	wai: water; kari: dig	Dig for water
Waikato	Waikato	wai: river; kato: to flow	Flowing water
Waikawa	Waikawa	wai: water; kawa: bitter	Bitter water
Waikawau	Waikawau	wai: water; kawau: shag	Water of the shag
Waikererū	Waikererū	wai: water; kererū: wood pigeon	Water of the wood pigeon
Waikeria	Waikeria	wai: water; keria: dug out	Dug out water
Waikerikeri	Waikerikeri	wai: water; kerikeri: to rush along violently	Water that rushes along
Waikiekie	Waikiekie	wai: water; kiekie: a climbing plant	Kiekie waters
Waikino	Waikino	wai: water; kino: unpleasant, stinking	Harmful waters
Waikirikiri	Waikirikiri	wai: stream; kirikiri: gravel	Gravelly stream
Waikite	Waikite	wai: water; kite: to see or gaze upon	Discovered water
Waikiwi	Waikiwi	wai: stream; kiwi: a flightless nocturnal bird	Kiwi waters
Waikōau	Waikōau	wai: water; kōau: shag	Waters of the shag
Waikohu	Waikohu	wai: water; kohu: mist	Misty waters
Waikōkopu	Waikōkopu	wai: water; kōkopu: cockabully fish	Waters of the cockabully
Waikōkōwai	Waikōkōwai	wai: water; kōkōwai: red ochre	Waters of the red ochre
Waikorea	Waikorea	wai: water; korea: a small canoe	Waters of the small canoe
Waikouaiti	Waikouaiti	wai: stream; koua (the poetical form of kua): to become; iti: little	Stream which has become small
Waikoukou	Waikoukou	wai: water; koukou: morepork or native owl	Water of the morepork
Waikōwhai	Waikōwhai	wai: stream; kowhai: native tree	Kōwhai tree waters
Waikōwhitiwhiti	Waikōwhitiwhiti	wai: water; kōwhitiwhiti: dancing (of water)	Dancing waters
Waikuku	Waikuku	wai: water; kuku: freshwater mussel	Freshwater mussel waters
Waikumete	Waikumete	wai: water; kumete: wooden bowl often used to snare wood pigeons	Waters of the kumete bowl
Waikuta	Waikuta	wai: water; kuta: rushes	Waters of the kuta rushes
Waimā	Waimā	wai: river; mā: white or clear	Clear water
Wai-māeroero	Wai-māeroero	wai: water; māeroero: ogres of the South Island forests	Waters of the ogres of the forests
Waimāhaka	Waimāhaka	wai: waters; māhaka (māhanga): twin	Twin waters
Waimahora	Waimahora	wai: water; mahora: spread out	Spread out waters
Waimahuru	Waimahuru	wai; stream; mahuru: placid	Placid waters
Waimakariri	Waimakariri	wai: river; makariri: cold	Cold river
Waimamaku	Waimamaku	wai: stream; mamaku: tree-fern	Tree-fern stream
Waimana	Waimana	wai: stream; mana: esteem or influence	Stream of influence
Waimangaroa	Waimangaroa	wai: river; manga: tributary; roa: long	River with a long tributary
Waimangu	Waimangu	wai: water; mangu: black	Black water
Waimārama	Waimārama	wai: water; mārama: clear	Clear water
Waimarie	Waimarie	wai: water; marie: quiet	Quiet water
Waimarino	Waimarino	wai: water or stream; marino: calm or still	Calm stream
Waimaru	Waimaru	wai; water; maru: shade or sheltered	Sheltered water
Waimātaitai	Waimātaitai	wai; water; mātaitai: salty or brackish water	Salty water
Waimate	Waimate	wai: water; mate: dead, sick or stagnant	Stagnant water
Waimatua	Waimatua	wai: water; matua: large or important	Important water
Waimatuku	Waimatuku	wai: water; matuku: bittern	Bittern water
Waimauku	Waimauku	wai: stream; mauku: small ferns	Fern water
Waimaunga	Waimaunga	wai: stream; maunga: mountain	Mountain stream
Waimimi	Waimimi	wai: stream; mimi: urine	Urine stream
Waimiro	Waimiro	wai: stream; miro: a native tree	Miro stream
Waimotu	Waimotu	wai: water or river; motu: island	Island stream
Waimumu	Waimumu	wai: stream; mumu: boisterous	Boisterous stream
Waingake	Waingake	wai: water; ngake: capacious, or the middle section of a fishing net	Waters to fill a large net
Waingaro	Waingaro	wai: water or stream; ngaro: lost or hidden	Lost stream
Waingongoro	Waingongoro	wai: river; ngongoro: to snore or gurgle	Gurgling water
Wainoni	Wainoni	wai: stream; noni: bend or turn	Bendy stream
Wainui	Wainui	wai: water; nui: large	Large waters
Wainuiomata	Wainuiomata	wai: stream; nui: big; o: of; Mata: a personal name	Big stream of Mata
Wainuioru	Wainuioru	wai: water or stream; nui: large; o of; Ru: personal name	Large waters of Ru
Waiohau	Waiohau	wai: water; o: of; Hau: personal name	Waters of Hau
Waiohine	Waiohine	wai: river; o: of; Hine	River of Hine
Waiomatatini	Waiomatatini	wai: water or stream; o: of; Matatini	Stream of Matatini
Waiomio	Waiomio	wai: water or stream; o: of; Mio	Stream of Mio
Waiomu	Waiomu	wai: water or stream; o: of; Mu	Stream of Mu
Waione	Waione	wai: water; one: beach or sand	Stream on the beach
Waiongana	Waiongana	wai: water or stream; o: of; Ngana	Stream of Ngata
Wai-ora-a-Tāne	Wai-ora-a-Tāne	wai: water; ora: life; a: of; Tāne	The life-giving water of Tāne
Waiorongomai	Waiorongomai	wai: water or stream; o: of; Rongomai	Stream of Rongomai
Waiotahi	Waiotahi	wai: water or stream; o: of; Tahi	Stream of Tahi
Wai-o-taiki	Wai-o-taiki	te: the; wai: stream; o: of; Taiki	Stream of Taiki
Waiotapu	Waiotapu	wai: water; o: of; tapu: sacred or reserved	Sacred waters
Waiotemarama	Waiotemarama	wai: water; o: of; Te Marama	Waters of Te Marama
Waiotira	Waiotira	wai: water or pool; a: of; tira: to set up sticks for divination	Pool of divination
Waiotū	Waiotū	wai: water; o: of; Tū: a personal name	Waters of Tū
Waiouru	Waiouru	wai: river; o:of; uru: west	River of the west
Waipā	Waipā	wai: river; pā: fortified village or villages	River of fortified villages
Waipahi	Waipahi	wai: water; Pahi	Stream of Pahi
Waipāhīhī	Waipāhīhī	wai: water; pāhīhī: welling up or flowing in driblets	Water flowing in driblets
Waipakaru	Waipakaru	wai: water; pakaru: broken	Stream broken through
Waipango	Waipango	wai: water; pango: black	Black water
Waipapa	Waipapa	wai: stream; papa: flat	Stream on flats
Waipapakauri	Waipapakauri	wai: water; papa: flat; kauri: native tree	Swampy ground where the kauri grow
Waipaparoa	Waipaparoa	wai: water; papa: flat; roa: long	Stream on long flats
Waipara	Waipara	wai: water; para: mud, silt or sediment	Silty water
Waipareira	Waipareira	wai: water; Pareira	Stream of Pareira
Waipari	Waipari	wai: stream; pari: cliff	Clifftop stream
Waipati	Waipati	wai: water; pati: shallow or splashing	Shallow waters
Waipātiki	Waipātiki	wai: water; pātiki: flounder	Flounder waters
Waipatu	Waipatu	wai: water; patu: struck	Strike water
Waipeto	Waipeto	wai: stream; peto: to be consumed	Consumed by the stream
Waipīata	Waipīata	wai: water; pīata: glistening or clear	Clear water
Waipipi	Waipipi	wai: water; pipi: cockle	Pipi waters
Waipiro	Waipiro	wai: water; piro: evil-smelling	Evil-smelling water
Waipōua	Waipōua	wai: water; pō: night; ua: rain	Water from rain in the night
Waipounamu	Waipounamu	wai: river; pounamu: greenstone	Greenstone waters
Waipōuri	Waipōuri	wai: water or stream; pōuri: dark or sad.	Dark waters
Waipū	Waipū	wai: water; pū: reddish in colour	Reddish water
Waipuhinui	Waipuhinui	wai: water; puhi: plume at the bow of a war canoe; nui: large	Water of the large canoe bow plume
Waipuku	Waipuku	wai: water; puku: to swell	Swelling water
Waipukurau	Waipukurau	wai: stream; pukurau: a large white fungus	Stream of the pukurau fungus
Wairākei	Wairākei	wai: water; rākei: adorning	A place where pools of water were used as mirrors
Wairangi	Wairangi	wai: water; rangi: sky	Water skies
Wairarapa	Wairarapa	wai: water; rarapa: glistening	Glistening water
Waireka	Waireka	wai: water; reka: sweet	Sweet water
Wairepo	Wairepo	wai: water; repo; swamp	Swampy water
Wairere	Wairere	wai: water or stream; rere: to flow	Waterfall
Wairio	Wairio	wai: water or stream; rio: dried up	Dried-up stream
Wairoa	Wairoa	wai: river or stream; roa: long	Long stream
Wairongoā	Wairongoā	wai: springs; rongoā: medicine	Medicinal stream
Wairua	Wairua	wai: stream or river; rua: two	Twin waters
Wairuna	Wairuna	wai: stream; runa: dock	Dock waters
Wairunga	Wairunga	wai: water; runga: above	Stream that flows from the mountains
Waitaanga	Waitaanga	wai: stream; a of; Anga	Stream of Anga
Waitaha	Waitaha	wai: river or stream; taha: to pass on one side	Backwater
Waitahanui	Waitahanui	wai: stream; tahanui: a variety of cabbage tree with broad leaves	Stream of cabbage trees
Waitahora	Waitahora	wai: water; tahora: spread out or open space	Wide-open waters
Waitahu	Waitahu	wai: stream; tahu: continuous or running in a straight line	Straight-running stream
Waitahuna	Waitahuna	wai: stream; Tāhuna: a personal name	Stream of Tāhuna
Waitai	Waitai	wai: water; tai: salt or brackish	Salty water
Waitakaro	Waitakaro	wai: stream; takaro: to play or wrestle	Wrestling waters
Waitakaruru	Waitakaruru	wai: water; takaruru: stagnant	Stagnant water
Waitākere	Waitākere	wai: water or stream; tākere: deep or cascading	Cascading stream
Waitaki	Waitaki	wai: river; taki (tangi): noisy or weeping	Weeping waters
Waitāne	Waitāne	wai: river; tāne: man or men	River of men
Waitangi	Waitangi	wai: waters; tangi: noisy or weeping	Weeping waters
Waitangiruru	Waitangiruru	wai: water or stream; tangi: to sound; ruru: morepork	Stream that sounds like a morepork
Waitanguru	Waitanguru	wai: water; tanguru: rushing rapidly	Rapidly rushing water
Waitao	Waitao	wai: water; tao: spear	Spear waters
Waitapu	Waitapu	wai: water: tapu: sacred or forbidden	Sacred waters
Waitaramea	Waitaramea	wai: stream; taramea: speargrass	Speargrass stream
Waitararoa	Waitararoa	wai:water; tara: sun’s ray or shafts of light; roa: long	First rays of the sun appearing on the water
Waitārere	Waitārere	wai: stream; tārere: to flow copiously	Copiously flowing waters
Waitaria	Waitaria	wai: water; taria: to wait for	Waters of waiting
Waitaruke	Waitaruke	wai: stream; taruke: hurrying	Hurrying stream
Waitata	Waitata	wai: water; tata: to dash or beat down	Dashing stream
Waitawa	Waitawa	wai: stream; tawa: tree	Tawa tree stream
Waitāwheta	Waitāwheta	wai: water; tāwheta: to flounder	Restless stream
Waitekauri	Waitekauri	wai: stream; te: the; kauri: native tree	Stream of the kauri tree
Waitepeka	Waitepeka	wai: stream; te: the; peka: branch	Tributary stream
Waiterimu	Waiterimu	wai: stream; te: the; rimu: native tree	Stream of the rimu tree
Waiteti	Waiteti	wai: stream; te: the; tī: cabbage tree	Stream of the cabbage tree
Waitetuna	Waitetuna	wai: stream; te: the; tuna: eel	Stream of the eel
Waitiri	Waitiri	wai: water or stream; tiri: to toss about or disturb	Disturbed stream
Waitoa	Waitoa	wai: water; toa: rough or stormy	Rough waters
Waitoetoe	Waitoetoe	wai: water or stream; toetoe: native grass	Toetoe grass stream
Waitohi	Waitohi	wai: water; tohi: baptismal rite	Stream for baptismal rite
Waitohu	Waitohu	wai: water; tohu: to point out	Water that points out the way
Waitoki	Waitoki	wai: water; toki: adze	Adze waters
Waitomo	Waitomo	wai: water; tomo: shaft	Shafts from water
Waitoriki	Waitoriki	wai: water; tōriki: little	Small stream
Waitōtara	Waitōtara	wai: river; tōtara: native tree	Tōtara tree river
Waituhi	Waituhi	wai: water; tuhi: to glow	Glowing waters
Waitūī	Waitūī	wai: water; tūī: bird	Tūī waters
Waituna	Waituna	wai: stream; tuna: eel	Eel stream
Waiuku	Waiuku	wai: stream; uku: white clay	Stream with banks of white clay
Waiuta	Waiuta	wai: river; uta: inland, or to load a burden	Inland river
Waiwawa	Waiwawa	wai: stream; wawa: roaring	Roaring stream
Waiwera	Waiwera	wai: water; wera: hot	Hot water
Wai-whakaata	Wai-whakaata	wai: water; whakaata: to reflect	Reflecting waters
Waiwhero	Waiwhero	wai: water; whero: red	Red waters
Waiwhetū	Waiwhetū	wai: stream; whetū: star	Star-reflecting stream
Waiwhio	Waiwhio	wai: stream; whio: blue or whistling duck	Stream of the blue duck
Waiwhiu	Waiwhiu	wai: stream; whiu: sudden bend	Sudden bend in the stream
Wakanui	Wakanui	waka: canoe; nui: large or many	Many waka
Waronui	Waronui	waro: chasm or coals; nui: large	Large coals
Waitētē	Waitētē	wai: stream; tētē: shovel-nosed duck, now extinct	Shovel-nosed duck stream
Wēiti	Wēiti	wē: liquid or water; iti: little	Little waters
Whakaari	Whakaari	whakaari: To show or expose to view	Expose to view
Whakaroa	Whakaroa	Whaka (South Island form of whanga): harbour or bay; roa: long	Long harbour
Whangakoko	Whangakoko	whanga: harbour; koko: corner, or to take up with a shovel	Shovelled harbour
Whangamarino	Whangamarino	whanga: stretch of water; marino: peaceful	Peaceful harbour
Whangamata	Whangamata	whanga: harbour; mata: obsidian	Obsidian harbour
Whangamoa	Whangamoa	whanga: valley or sheltered place; moa: probably the raised mounds in a plantation	Valley with raised mounds in plantation
Whangamomona	Whangamomona	whanga: valley; momona: fat	Bountiful valley
Whanganui	Whanganui	whanga: bay; nui: large	Large harbour
Whanganui-o-Hei	Whanganui-o-Hei	whanga: bay; nui: large; o: of; Hei	Large harbour of Hei
Whangapara	Whangapara	whanga: harbour; para: sediment	Sedimentary harbour
Whangaparāoa	Whangaparāoa	whanga: bay; parāoa: whale	Whale bay
Whangapē	Whangapē	whanga: to wait; pē: fish roe	Fish roe harbour
Whangapoua	Whangapoua	whanga: bay or harbour; poua: a mollusc	Mollusc harbour
Whangarā	Whangarā	whanga: bay; rā: sun	Sunny bay
Whangarātā	Whangarātā	whanga: valley; rātā: native tree	Rātā tree valley
Whangarei	Whangarei	whanga: waiting; rei: abbreviation of Reipae	Waiting for Reipae
Whangaripo	Whangaripo	whanga: stretch of water; ripo: deep pool or whirlpool	Deep stretch of water
Whangaroa	Whangaroa	whanga: harbour; roa: long	Long harbour
Whangaruru	Whangaruru	whanga: harbour; ruru: morepork	Morepork harbour
Whangateau	Whangateau	whanga: harbour; te: the; au: current, smoke or mist	Harbour of smoke
Whangatoetoe	Whangatoetoe	whanga: bay; toetoe: native grass	Toetoe grass bay
Whānui	Whānui	whānui: wide	Wide-open waters
Whareroa	Whareroa	whare: house; roa: long	Long house
Whāro One-roa-a-Tohe	Whāro One-roa-a-Tohe	whāro: stretched out; one: beach; roa: long; a: of; Tohe, a chief	The beach on which Tōhē stretched out
Whataroa	Whataroa	whata: elevated stage: roa: long or tall	Long, elevated stage
Whekenui	Whekenui	wheke: octopus; nui: large	Great octopus
Whenuanui	Whenuanui	whenua: land; nui: large	Great land
Whenuapai	Whenuapai	whenua: land; pai: good	Good land
Whānui	Whānui	whānui: broad or wide	Wide
Wharanui	Wharanui	wharanui: species of flax	Wharanui flax
Whare	Whare	whare: house	House
Whareakeake	Whareakeake	whare: house; akeake: poor land, or a species of tree	House on poor land
Whareama	Whareama	whare: house; ama: carved posts supporting the maihi	House of carved posts
Wharehine	Wharehine	whare: house; hine: girls or young women	House of young women
Wharehuanui	Wharehuanui	whare: house; huanui: road or path	House by a path
Wharehuia	Wharehuia	whare: house; huia (the possessive case of hui): assembled	House of assembly
Wharehunga	Wharehunga	whare: house; hunga: company of people	Meeting house, or meeting of people in a house
Wharekaho	Wharekaho	whare: house; kaho: fence rail	Enclosed palisade
Wharekākā	Wharekākā	whare: probably nesting place; kākā: parrots	Nesting place of parrots
Wharekōpae	Wharekōpae	whare: house; kōpae: circular	House with a side door
Wharekōwhiti	Wharekōwhiti	whare: house; kō: father side; whiti: to cross	Cross to house on the far side
Whareongaonga	Whareongaonga	whare: house; ongaonga: nettle	Nettle house
Whareora	Whareora	whare: house; ora: safe or in good health	House of good health
Wharepāina	Wharepāina	whare: house; pāina: to warm oneself	House to warm oneself
Wharepapa	Wharepapa	whare: house; papa: flat	House flats
Wharepoa	Wharepoa	whare: house: poa: smouldering or smoking	Smouldering house
Whareponga	Whareponga	whare: house; ponga: tree-fern	Tree-fern house
Wharerātā	Wharerātā	whare: house; rātā: native tree	House among the rātā trees
Whatamangō	Whatamangō	whata: elevated food store: mangō (the same word as makō): shark	A stage for storing dried shark flesh
Whatatutu	Whatatutu	whata: elevated food platform; tutu: native tree or bush	Storage platform among the tutu bushes
Whatawhata	Whatawhata	whata: elevated food platform	Elevated food platforms
Whatitiri	Whatitiri	whatitiri: thunder	Thunder
Whatiwhatihoe	Whatiwhatihoe	whatiwhati: to break in pieces; hoe: paddle	Paddle broken into pieces
Whau	Whau	whau: a native tree	Whau tree
Whāwhārua	Whāwhārua	whāwhā: to feel about; rua: pit	Grope about in kūmara pit
Whenuahōu	Whenuahōu	whenua: land; hōu: new	New land
Whenuakite	Whenuakite	whenua: land; kite: discover	Discovered land
Whenuakura	Whenuakura	whenua: land; kura: red	Red land
Whetūkura	Whetūkura	whetū: star; kura: red	Red star
Whitianga	Whitianga	whitianga: the crossing	The crossing (of a river)
Whitikau	Whitikau	whiti: to cross; kau: to wade	Wade across